vvvvvvvvvvvvvvv
000mmmm00m00mm0
0m00000m0mm0m00
00mm0m000m0000m
m000mmmm000mm0m
000m00000mmm00m
mm0mmmm0mm000m0
000mmm0000mmmm0
0m000mm0m0mm000
0mm0m000m0000m0
00m00m0mm0m0mm0
mmm0mm0m00mm0m0
m000m00m0mm00mm
00mm00m00000mmm
mmmm0mmm0mm0mmm
00000mmm00m000f