vvvvvvvvvvvvvvv
s000mm00000000m
mmm0mm00m0mmm00
m0m0mm0mm000mm0
0000000mm0m000m
m0mm0m00m0mmm0m
m0m0mmm0m0000mm
m0m00000mmmm000
m0000mm0m0000m0
mmmm0mmmmmmm0m0
mm000000000mmm0
m0mm0mmmm000mm0
m000000m00m0mm0
m0mmmm0m0mm00mm
m00000mm00mmmmm
m0mmm0mmm00000f